7 7
#######
#@    #
#B    #
#     #
##### #
#     #
#######
