5 5
#####
# # #
#   #
### #
#####

